251 251 251 251 251 251 249 247 248 250 237 235 236 238 179 237 235 236 238 237 235 236 238 237 235 236 238 241 239 240 242 241 239 240 242 251 251 251 251 251 251 251 251 251 251 251 251 251 251 251 
251 251 251 251 251 251 245 243 244 246 251 251 176 173 174 175 177 251 251 251 251 251 251 251 251 251 251 237 235 236 238 237 235 236 238 251 251 251 251 251 251 251 251 251 251 251 251 251 251 251 
251 251 251 251 251 251 241 239 240 242 185 186 171 168 169 170 172 234 188 187 183 184 208 209 189 190 251 251 251 251 251 249 247 248 250 251 251 251 251 251 251 251 251 251 251 251 251 251 251 251 
251 251 251 251 251 251 237 235 236 238 204 203 203 203 203 203 203 203 203 203 203 203 203 203 203 205 178 251 251 251 251 245 243 244 246 251 251 251 251 251 251 251 251 251 251 251 251 251 251 251 
251 251 251 251 251 249 247 248 246 251 198 201 201 201 201 201 201 201 201 201 201 201 201 201 201 202 251 251 251 251 251 241 239 240 242 251 251 251 251 251 251 251 251 251 251 251 251 251 251 251 
251 251 251 251 251 245 243 244 246 251 196 195 195 195 195 195 195 195 195 195 195 195 195 194 201 202 206 207 251 251 251 237 235 236 238 251 251 251 251 251 251 251 251 251 251 251 251 251 251 251 
251 251 251 251 251 241 239 240 242 251 251 251 189 190 188 187 251 185 186 217 216 218 251 198 201 202 251 251 251 251 251 251 251 251 249 247 248 250 251 251 251 251 251 251 251 251 251 251 251 251 
251 251 251 251 251 237 235 236 238 251 251 251 251 251 251 251 251 251 251 214 213 215 251 198 201 202 188 187 225 226 227 251 251 251 245 243 244 246 251 251 251 251 251 251 251 251 251 251 251 251 
251 251 251 251 251 231 228 229 233 249 247 248 250 249 247 248 250 251 251 211 210 212 251 198 201 202 251 251 223 222 224 251 251 251 241 239 240 242 251 251 251 251 251 251 251 251 251 251 251 251 
251 251 251 251 251 251 251 251 251 245 243 244 246 245 243 244 246 251 204 203 203 203 203 192 201 202 251 251 220 219 221 251 251 251 237 235 236 238 251 251 251 251 251 251 251 251 251 251 251 251 
251 251 251 251 251 251 251 251 251 241 239 244 242 241 239 240 242 251 198 201 201 201 201 201 201 191 203 203 203 203 203 205 251 251 249 247 248 250 251 251 251 251 251 251 251 251 251 251 251 251 
251 251 251 251 251 251 251 251 251 237 235 236 238 237 235 236 238 251 196 195 195 195 195 194 201 201 201 201 201 201 201 202 251 251 245 243 244 246 251 251 251 251 251 251 251 251 251 251 251 251 
251 251 251 251 251 251 251 251 251 251 251 231 228 229 233 249 247 248 250 251 251 251 251 198 201 193 195 195 195 195 195 197 251 251 241 239 240 242 251 251 251 251 251 251 251 251 251 251 251 251 
251 251 251 251 251 251 251 251 251 251 251 251 251 251 251 245 243 244 246 251 251 206 207 198 201 202 234 251 251 185 186 251 251 251 237 235 236 238 251 251 251 251 251 251 251 251 251 251 251 251 
251 251 251 251 251 251 251 251 251 251 251 251 251 251 251 241 239 240 242 251 251 251 251 198 201 202 251 251 251 251 251 251 251 251 249 247 248 250 251 251 251 251 251 251 251 251 251 251 251 251 
251 251 251 251 251 251 251 251 251 251 251 251 251 251 251 237 235 236 238 251 217 216 218 198 201 202 251 251 251 251 251 251 251 251 245 243 244 246 251 251 251 251 251 251 251 251 251 251 251 251 
251 251 251 251 251 251 251 251 251 251 251 251 251 251 251 249 247 248 250 251 214 213 215 198 201 202 251 251 251 251 251 251 251 251 241 239 240 242 251 251 251 251 251 251 251 251 251 251 251 251 
251 251 251 251 251 251 251 251 251 251 251 251 251 251 251 245 243 244 246 251 211 210 212 198 201 202 188 187 251 251 251 251 251 251 237 235 236 238 251 251 251 251 251 251 251 251 251 251 251 251 
251 251 251 251 251 251 251 251 251 251 251 251 251 251 251 241 239 240 242 251 251 251 251 198 201 202 232 251 251 251 251 251 251 251 249 247 248 250 251 251 251 251 251 251 251 251 251 251 251 251 
251 251 251 251 251 251 251 251 251 251 251 251 251 251 251 237 235 236 238 251 251 183 184 198 201 202 251 251 251 251 251 251 251 251 245 243 244 246 251 251 251 251 251 251 251 251 251 251 251 251 
251 251 251 251 251 251 251 251 251 251 251 251 251 251 251 249 247 248 250 251 251 208 209 198 201 202 183 184 251 251 251 251 251 251 241 239 240 242 251 251 251 251 251 251 251 251 251 251 251 251 
251 251 251 251 251 251 251 251 251 251 251 251 251 251 251 245 243 244 246 204 203 203 203 192 201 202 185 186 251 251 251 251 251 251 237 235 236 238 251 251 251 251 251 251 251 251 251 251 251 251 
251 251 251 251 251 251 251 251 251 251 251 251 251 251 251 241 239 240 242 198 201 201 201 201 201 202 251 251 251 251 251 251 251 251 249 247 248 250 251 251 251 251 251 251 251 251 251 251 251 251 
251 251 251 251 251 251 251 251 251 251 251 251 251 251 251 237 235 236 238 196 195 195 195 194 201 202 189 190 251 251 251 251 251 251 245 243 244 246 251 251 251 251 251 251 251 251 251 251 251 251 
251 251 251 251 251 251 251 251 251 251 251 251 251 251 249 247 248 250 251 251 251 251 251 198 201 202 208 209 251 251 251 251 251 251 241 239 240 242 231 228 229 233 251 251 251 251 251 251 251 251 
251 251 251 251 251 251 251 251 251 251 251 251 251 251 245 243 244 246 251 251 225 226 227 198 201 202 251 251 251 251 251 251 251 251 237 235 236 238 249 247 248 250 251 251 251 251 251 251 251 251 
251 251 251 251 251 251 251 251 251 251 251 251 251 251 241 239 240 242 251 251 223 222 224 198 201 202 251 251 251 251 251 251 217 216 218 251 251 251 245 243 244 246 251 251 251 251 251 251 251 251 
251 251 251 251 251 251 251 251 251 251 251 251 251 251 237 235 236 238 251 232 220 219 221 198 201 202 251 251 251 251 251 251 214 213 215 251 251 251 241 239 240 242 251 251 251 251 251 251 251 251 
251 251 251 251 251 251 251 251 251 251 251 251 249 247 248 250 204 203 203 203 203 203 203 192 201 202 251 231 228 229 233 251 211 210 212 251 251 251 237 235 236 238 251 251 251 251 251 251 251 251 
251 251 251 251 251 251 251 251 251 251 251 251 245 243 244 246 198 201 201 201 201 201 201 201 201 191 203 203 203 203 203 203 203 203 203 203 205 251 251 249 247 248 250 251 251 251 251 251 251 251 
251 251 251 251 251 251 251 251 251 251 251 251 241 239 240 242 196 195 195 195 195 195 195 194 201 201 201 201 201 201 201 201 201 201 201 201 202 251 251 245 243 244 246 251 251 251 251 251 251 251 
251 251 251 251 251 251 251 251 251 251 251 251 237 235 236 238 231 228 229 233 251 251 251 198 201 193 195 195 195 195 195 195 195 195 194 201 202 251 251 241 239 240 242 251 251 251 251 251 251 251 
251 251 251 251 251 251 251 251 251 251 251 251 251 251 251 249 247 248 250 251 251 251 251 198 201 202 188 187 185 186 230 251 251 232 198 201 202 251 251 237 235 236 238 251 251 251 251 251 251 251 
251 251 251 251 251 251 251 251 251 251 251 251 251 251 251 245 243 244 246 251 251 185 186 198 201 202 251 251 251 251 251 251 251 251 198 201 202 185 186 249 247 248 250 251 251 251 251 251 251 251 
251 251 251 251 251 251 251 251 251 251 251 251 251 251 251 241 239 240 242 251 251 251 251 198 201 202 251 251 251 251 251 251 188 187 198 201 202 251 251 245 243 244 246 251 251 251 251 251 251 251 
251 251 251 251 251 251 251 251 251 251 251 251 251 251 251 237 235 236 238 251 251 251 251 198 201 202 189 190 251 251 251 251 251 251 198 201 202 251 251 241 239 240 242 251 251 251 251 251 251 251 
251 251 251 251 251 251 251 251 251 251 251 251 249 247 248 250 251 251 251 251 251 251 251 198 201 202 183 184 251 251 251 251 251 251 198 201 202 188 187 237 235 236 238 251 251 251 251 251 251 251 
251 251 251 251 251 251 251 251 231 228 229 233 245 243 244 246 251 251 251 208 209 188 187 198 201 202 251 251 251 251 251 251 206 207 198 201 202 189 190 249 247 248 250 251 251 251 251 251 251 251 
249 247 248 250 249 247 248 250 249 247 248 250 241 239 240 242 251 251 251 204 203 203 203 192 201 202 232 251 251 251 251 251 251 251 198 201 202 234 251 245 243 244 246 251 251 251 251 251 251 251 
245 243 244 246 245 243 244 246 245 243 244 246 237 235 236 238 251 189 190 198 201 201 201 201 201 202 251 251 251 251 251 251 251 234 198 201 202 251 251 241 239 240 242 251 251 251 251 251 251 251 
241 239 240 242 241 239 240 242 241 239 240 242 251 251 217 216 218 251 251 196 195 195 195 194 201 202 185 186 251 225 226 227 189 190 198 201 202 251 251 237 235 236 238 251 251 251 251 251 251 251 
237 235 236 238 237 235 236 238 237 235 236 238 251 251 214 213 215 251 251 251 251 251 251 198 201 202 251 251 251 223 222 224 183 184 198 201 202 208 209 249 247 248 250 251 251 251 251 251 251 251 
249 247 248 250 249 248 249 250 185 186 188 187 251 251 211 210 212 251 251 251 183 184 234 198 201 202 251 251 230 220 219 221 251 232 198 201 202 188 187 245 243 244 246 251 251 251 251 251 251 251 
245 243 244 246 245 243 244 246 204 203 203 203 203 203 203 203 203 203 203 203 203 203 203 192 201 191 203 203 203 203 203 203 203 203 192 201 202 251 251 241 239 240 242 251 251 251 251 251 251 251 
241 239 240 242 241 239 240 242 198 201 201 201 201 201 201 201 201 201 201 201 201 201 201 201 201 201 201 201 201 201 201 201 201 201 201 201 202 251 251 237 235 236 238 251 251 251 251 251 251 251 
237 235 236 238 237 235 236 238 196 195 195 195 195 195 195 195 195 195 195 195 195 195 195 195 195 195 195 195 195 195 195 195 195 195 195 195 197 185 186 251 249 247 248 250 251 251 251 251 251 251 
249 247 248 250 249 247 248 250 249 247 248 250 249 247 248 250 249 247 248 250 249 247 248 250 249 247 248 250 249 247 248 250 249 247 248 250 249 247 248 250 245 243 244 246 251 251 251 251 251 251 
245 243 244 246 245 243 244 246 245 243 244 246 245 243 244 246 245 243 244 246 245 243 244 246 245 243 244 246 245 243 244 246 245 243 244 246 245 243 244 246 241 239 240 242 251 251 251 251 251 251 
241 239 240 242 241 239 240 242 241 239 240 242 241 239 240 242 241 239 240 242 241 239 240 242 241 239 240 242 241 239 240 242 241 239 240 242 241 239 240 242 237 235 236 238 251 251 251 251 251 251 
237 235 236 238 237 235 236 238 237 235 236 238 237 235 236 238 237 235 236 238 237 235 236 238 237 235 236 238 237 235 236 238 237 235 236 238 237 235 236 238 251 251 251 251 251 251 251 251 251 251 
