398 398 398 398 398 398 398 398 398 398 398 398 398 398 398 398 398 398 398 398 398 398 398 398 398 398 398 398 398 398 398 398 398 398 398 398 392 390 391 393 398 398 398 398 421 422 422 422 423 398 
398 398 398 398 398 398 398 398 398 398 398 398 398 398 398 398 398 398 398 398 398 398 398 398 398 398 398 398 398 398 398 398 396 394 395 397 388 386 387 389 398 398 398 398 421 422 422 415 420 398 
398 398 398 398 398 398 398 398 398 398 398 398 398 398 398 398 398 398 398 398 398 398 398 398 398 398 398 398 398 398 398 398 388 386 386 389 384 382 383 385 398 398 398 425 416 422 415 420 398 398 
398 398 398 398 398 398 398 398 398 398 398 398 398 398 398 398 398 398 398 398 398 398 398 398 398 398 398 398 398 398 398 398 392 390 391 393 398 398 398 412 411 413 425 416 422 422 423 406 407 398 
398 398 398 398 398 398 398 398 398 398 398 398 398 398 398 398 398 398 398 398 398 398 398 398 398 398 398 398 396 394 395 397 388 386 387 389 398 398 398 409 408 410 421 422 422 415 420 404 405 398 
398 398 398 398 398 398 398 398 398 398 398 398 398 398 398 398 398 398 398 398 398 398 398 398 398 398 398 398 388 386 387 389 384 382 383 385 398 398 425 424 424 424 416 422 422 423 398 398 398 398 
398 398 398 398 398 398 398 398 398 398 398 398 398 398 398 398 398 398 398 398 398 398 398 398 398 398 398 398 392 390 391 393 398 398 398 398 425 424 416 422 422 422 422 422 422 423 396 394 395 397 
398 398 398 398 398 398 398 398 398 398 398 398 398 398 398 398 398 398 398 398 398 398 398 398 398 398 398 398 388 386 387 389 398 398 398 425 416 422 422 422 422 422 422 422 422 423 392 390 391 393 
398 398 398 398 398 398 398 398 398 398 398 398 398 398 398 398 398 398 398 398 398 398 398 398 398 398 398 398 392 390 391 393 398 398 425 416 422 422 422 415 418 418 418 418 418 420 388 386 387 389 
398 398 398 398 398 398 398 398 398 398 398 398 398 398 398 398 398 398 398 398 398 398 398 398 396 394 395 397 388 386 387 389 398 425 416 422 422 415 418 420 398 398 398 398 398 398 384 382 383 385 
398 398 398 398 398 398 398 398 398 398 398 398 398 398 398 398 398 398 398 398 398 398 398 398 388 386 387 389 384 382 383 385 425 416 422 422 415 420 406 407 396 394 395 397 396 394 395 397 398 398 
398 398 398 398 398 398 398 398 398 398 398 398 398 398 398 398 398 398 398 398 398 398 398 398 392 390 391 393 398 398 406 407 421 422 422 422 423 398 404 405 392 390 391 393 392 390 391 393 398 398 
398 398 398 398 398 398 398 398 398 398 398 398 398 398 398 398 398 398 398 398 398 398 398 398 388 386 387 389 398 398 404 405 421 422 422 422 423 398 398 398 388 386 387 389 388 386 387 389 398 398 
398 398 398 398 398 398 398 398 398 398 398 398 398 398 398 398 398 398 398 398 398 398 398 398 384 382 383 385 398 398 425 424 416 422 422 422 423 398 398 398 384 382 383 385 384 382 383 384 398 398 
398 398 398 398 398 398 398 398 398 398 398 398 398 398 398 398 398 398 398 398 398 398 398 398 396 394 395 397 425 424 416 422 422 422 422 415 420 396 394 395 397 398 398 398 398 398 398 398 398 398 
398 398 398 398 398 398 398 398 398 398 398 398 398 398 398 398 398 398 398 398 398 398 398 398 388 386 387 389 421 422 422 422 415 418 418 420 398 392 390 391 393 398 398 398 398 398 398 398 398 398 
398 398 398 398 398 398 398 398 398 398 398 398 398 398 398 398 396 394 395 397 396 394 395 397 384 382 383 385 421 422 422 415 420 398 398 398 398 388 386 387 389 398 398 398 398 398 398 398 398 398 
398 398 398 398 398 398 398 398 398 398 398 398 398 398 398 398 388 386 387 389 384 382 383 385 398 398 398 398 421 422 422 423 398 398 398 398 398 384 382 383 385 398 398 398 398 398 398 398 398 398 
398 398 398 398 398 398 398 398 398 398 398 398 396 394 395 397 384 382 383 385 398 398 398 412 411 413 398 398 421 422 422 423 398 396 394 395 397 398 398 398 398 398 398 398 398 398 398 398 398 398 
398 398 398 398 398 398 398 398 398 398 398 398 384 382 383 385 398 398 398 398 406 407 398 409 408 410 398 398 421 422 422 423 398 392 390 391 393 398 398 398 398 398 398 398 398 398 398 398 398 398 
398 398 398 398 398 398 398 398 398 398 398 396 394 395 397 398 398 398 398 398 404 405 425 424 424 424 424 424 416 422 422 423 398 388 386 387 389 398 398 398 398 398 398 398 398 398 398 398 398 398 
398 398 398 398 398 398 398 398 398 398 398 388 386 387 389 398 398 398 398 398 425 424 416 422 422 422 422 422 422 422 422 423 398 392 390 391 393 398 398 398 398 398 398 398 398 398 398 398 398 398 
398 398 398 398 398 398 398 398 398 398 398 392 390 391 393 398 398 398 425 424 416 422 422 422 422 422 422 422 422 422 422 423 398 388 386 387 389 398 398 398 398 398 398 398 398 398 398 398 398 398 
398 398 398 398 398 398 398 398 398 398 398 388 386 387 389 398 398 398 421 422 422 422 415 418 418 418 418 418 418 418 418 420 398 384 382 383 385 398 398 398 398 398 398 398 398 398 398 398 398 398 
398 398 398 398 398 398 398 398 398 398 398 384 382 383 385 398 398 398 419 414 422 422 423 398 398 406 407 398 398 398 398 396 394 395 397 398 398 398 398 398 398 398 398 398 398 398 398 398 398 398 
398 398 398 398 398 398 398 398 398 398 398 398 396 394 395 397 398 406 407 421 422 422 423 398 398 404 405 398 398 398 398 392 390 391 393 398 398 398 398 398 398 398 398 398 398 398 398 398 398 398 
398 398 398 398 398 398 398 398 398 398 398 398 388 386 387 389 398 404 405 421 422 422 417 426 398 398 398 396 394 395 397 388 386 387 389 398 398 398 398 398 398 398 398 398 398 398 398 398 398 398 
398 398 398 398 398 398 398 398 398 398 398 398 384 382 383 385 398 398 398 419 414 422 422 423 398 398 398 388 386 387 389 384 382 383 385 398 398 398 398 398 398 398 398 398 398 398 398 398 398 398 
398 398 398 398 398 398 398 398 398 398 398 398 398 398 396 394 395 397 398 398 419 414 422 417 426 398 398 384 382 383 385 398 398 398 398 398 398 398 398 398 398 398 398 398 398 398 398 398 398 398 
398 398 398 398 398 398 398 398 398 398 398 398 398 398 392 390 391 393 398 398 398 421 422 422 417 426 398 398 398 398 396 394 395 397 398 398 398 398 398 398 398 398 398 398 398 398 398 398 398 398 
398 398 398 398 398 398 398 398 398 398 398 398 398 398 388 386 387 389 398 398 398 419 418 418 414 417 424 426 398 398 392 390 391 393 398 398 398 398 398 398 398 398 398 398 398 398 398 398 398 398 
398 398 398 398 398 398 398 398 398 398 398 398 398 398 384 382 383 385 398 398 398 398 398 398 421 422 422 423 398 398 388 386 387 389 398 398 398 398 398 398 398 398 398 398 398 398 398 398 398 398 
398 398 398 398 398 398 398 398 398 398 398 398 398 398 398 398 396 394 395 397 398 398 398 398 421 422 422 423 398 398 384 382 383 385 398 398 398 398 398 398 398 398 398 398 398 398 398 398 398 398 
398 398 398 398 398 398 398 398 398 398 398 398 396 394 395 397 384 382 383 385 398 398 398 398 421 422 422 423 398 398 398 398 396 394 395 397 398 398 398 398 398 398 398 398 398 398 398 398 398 398 
398 398 398 398 398 398 398 398 398 398 398 398 388 386 387 389 398 412 411 413 398 398 425 424 416 422 422 423 406 407 398 398 388 386 387 389 398 398 398 398 398 398 398 398 398 398 398 398 398 398 
398 398 398 398 398 398 398 398 396 394 395 397 392 390 391 393 398 409 408 410 398 425 416 422 415 418 418 420 404 405 398 398 392 390 391 393 398 398 398 398 398 398 398 398 398 398 398 398 398 398 
398 398 398 398 396 395 395 397 388 386 387 389 388 386 387 389 425 424 424 424 424 416 422 422 423 406 407 398 398 398 398 398 388 386 387 389 398 398 398 398 398 398 398 398 398 398 398 398 398 398 
396 394 395 397 388 386 387 389 392 390 391 393 384 382 383 385 421 422 422 422 422 422 415 418 420 404 405 398 398 398 398 398 384 382 383 385 398 398 398 398 398 398 398 398 398 398 398 398 398 398 
392 390 391 393 392 390 391 393 388 386 387 389 398 398 398 398 421 422 422 422 422 422 423 398 398 398 398 398 396 394 395 397 398 398 398 398 398 398 398 398 398 398 398 398 398 398 398 398 398 398 
388 386 387 389 388 386 387 389 384 382 383 385 398 398 425 424 416 422 415 418 418 418 420 398 396 394 395 397 384 382 383 385 398 398 398 398 398 398 398 398 398 398 398 398 398 398 398 398 398 398 
392 390 391 393 384 382 383 385 398 398 398 398 425 424 416 422 422 422 423 412 411 413 398 398 392 390 391 393 398 398 398 398 398 398 398 398 398 398 398 398 398 398 398 398 398 398 398 398 398 398 
388 386 387 389 412 411 413 406 407 398 398 425 416 422 422 415 418 418 420 409 408 410 398 398 388 386 387 389 398 398 398 398 398 398 398 398 398 398 398 398 398 398 398 398 398 398 398 398 398 398 
392 390 391 393 409 408 410 404 405 425 424 416 422 422 422 423 398 398 398 398 398 398 398 398 384 382 383 385 398 398 398 398 398 398 398 398 398 398 398 398 398 398 398 398 398 398 398 398 398 398 
388 386 387 389 425 424 424 424 424 416 422 422 415 418 418 420 398 398 398 398 396 394 396 397 398 398 398 398 398 398 398 398 398 398 398 398 398 398 398 398 398 398 398 398 398 398 398 398 398 398 
392 390 391 393 421 422 422 422 422 422 422 422 423 406 407 398 396 394 395 397 388 386 387 389 398 398 398 398 398 398 398 398 398 398 398 398 398 398 398 398 398 398 398 398 398 398 398 398 398 398 
388 386 387 389 419 418 418 418 418 418 418 418 420 404 405 398 392 390 391 393 384 382 383 385 398 398 398 398 398 398 398 398 398 398 398 398 398 398 398 398 398 398 398 398 398 398 398 398 398 398 
392 386 391 393 396 394 395 397 396 394 395 397 396 394 395 397 388 386 387 389 398 398 398 398 398 398 398 398 398 398 398 398 398 398 398 398 398 398 398 398 398 398 398 398 398 398 398 398 398 398 
392 390 391 393 392 390 391 393 392 390 391 393 392 390 391 393 384 382 383 385 398 398 398 398 398 398 398 398 398 398 398 398 398 398 398 398 398 398 398 398 398 398 398 398 398 398 398 398 398 398 
388 386 387 389 388 386 387 389 388 386 387 389 388 386 387 389 398 398 398 398 398 398 398 398 398 398 398 398 398 398 398 398 398 398 398 398 398 398 398 398 398 398 398 398 398 398 398 398 398 398 
384 382 383 385 384 382 383 385 384 382 383 385 384 382 383 385 398 398 398 398 398 398 398 398 398 398 398 398 398 398 398 398 398 398 398 398 398 398 398 398 398 398 398 398 398 398 398 398 398 398 
