139 131 131 131 131 131 131 131 138 131 131 131 131 131 131 131 131 131 131 131 131 131 131 131 131 131 131 131 131 131 131 140 53 54 53 79 79 79 79 79 82 82 82 82 82 82 82 82 82 82 
132 53 53 53 53 53 53 54 132 11 11 11 11 11 11 11 11 11 11 11 11 11 11 11 11 11 11 11 11 11 11 132 53 53 53 79 79 82 82 82 82 82 82 82 82 82 82 82 82 82 
132 53 53 96 97 98 53 53 136 131 131 131 131 131 131 131 131 131 131 131 131 131 131 131 131 131 131 131 131 140 11 132 53 53 53 79 84 82 82 82 82 82 82 82 82 82 82 82 82 82 
132 53 53 94 93 95 53 54 132 53 53 53 120 121 53 53 120 121 53 53 120 121 53 53 53 53 53 53 53 132 11 132 53 53 53 79 85 82 82 82 82 82 82 82 82 82 82 82 82 82 
132 53 53 91 90 92 53 53 143 53 53 53 118 119 53 53 118 119 53 53 118 119 53 53 53 53 53 53 53 132 11 132 53 53 79 79 84 82 82 82 82 82 82 82 82 82 82 82 82 82 
132 53 53 53 72 71 71 71 111 71 71 71 71 71 71 71 71 71 71 71 71 71 71 71 71 71 73 53 53 132 11 132 53 79 79 79 85 82 82 82 82 82 82 82 82 82 82 82 82 82 
132 53 53 53 67 66 66 66 111 66 66 66 66 66 66 66 66 66 66 66 66 66 66 66 65 65 70 53 53 132 11 132 53 79 79 79 82 82 82 82 82 82 82 82 82 82 82 82 82 82 
136 131 138 131 131 131 131 131 141 53 53 53 53 53 53 53 53 53 53 53 53 53 53 53 69 65 70 53 53 132 11 132 53 79 84 82 82 82 82 82 82 82 82 82 82 82 82 82 82 82 
132 11 132 53 146 147 53 53 146 147 53 53 146 147 53 53 146 147 53 53 146 147 53 53 69 65 70 146 147 132 11 132 53 79 85 82 82 82 82 82 82 82 82 82 82 82 82 82 82 82 
132 11 132 53 144 145 53 53 144 145 53 53 144 145 53 53 144 145 53 53 144 145 53 53 69 65 70 144 145 132 11 132 53 79 84 82 82 82 82 82 82 82 82 82 82 82 82 82 82 82 
132 11 132 53 72 71 71 71 71 71 71 71 71 71 71 71 71 71 71 71 71 71 71 71 69 65 70 53 53 132 11 132 53 79 85 82 82 82 82 82 82 82 82 82 82 82 82 82 82 82 
132 11 132 53 67 66 66 66 66 66 66 66 66 66 66 66 66 66 66 66 66 66 66 66 69 65 70 53 53 132 11 132 53 79 84 82 82 82 82 82 82 82 82 82 82 82 82 82 82 82 
132 11 132 53 120 121 53 53 120 121 53 53 120 121 53 53 120 121 53 53 120 121 53 53 69 65 70 53 53 132 11 132 53 79 85 82 82 82 82 82 82 82 82 82 82 82 82 82 82 82 
132 11 132 53 118 119 53 53 118 119 53 53 118 119 53 53 118 119 53 53 118 119 53 53 69 65 70 53 53 132 11 132 53 79 84 82 82 82 82 82 82 82 82 82 82 82 82 82 82 82 
132 11 132 53 53 53 53 53 53 53 53 53 53 53 53 53 53 53 53 53 53 53 53 53 69 65 70 53 53 132 11 132 53 79 85 82 82 82 82 82 82 82 82 82 82 82 82 82 82 82 
132 11 134 131 131 131 131 131 131 131 131 131 131 131 131 131 131 131 131 131 131 131 131 140 69 65 70 139 131 135 11 132 53 79 84 83 82 82 82 82 82 82 82 82 82 82 82 82 82 82 
132 11 11 11 11 11 11 11 11 11 11 11 11 11 11 11 11 11 11 11 11 11 11 132 111 111 111 132 11 11 11 132 53 79 85 82 82 82 82 82 82 82 82 82 82 82 82 82 82 82 
134 131 131 131 131 131 131 131 131 131 131 131 131 131 131 131 131 131 131 131 131 131 131 135 69 65 70 134 131 131 131 135 53 79 82 82 82 82 82 82 82 82 82 82 82 82 82 82 82 82 
53 53 53 53 53 53 53 53 53 53 53 53 53 53 53 53 53 53 53 0 1 2 3 53 65 65 70 53 53 53 53 53 79 84 82 82 82 82 82 82 82 82 82 82 82 82 82 82 82 82 
53 53 53 53 53 53 53 53 53 53 53 53 53 53 53 53 53 53 53 0 1 2 3 53 69 65 70 53 53 53 53 79 79 85 82 82 82 82 82 82 82 82 82 82 82 82 82 82 82 82 
53 53 53 53 53 53 53 53 53 53 53 53 53 53 53 53 53 53 53 0 1 2 3 55 69 65 70 53 53 53 53 79 79 84 82 82 82 82 82 82 82 82 82 82 82 82 82 82 82 82 
53 53 53 53 53 53 53 53 53 53 53 53 53 53 53 53 53 53 53 0 1 2 3 55 69 65 70 54 53 53 53 53 79 85 82 82 82 82 82 82 82 82 82 82 82 82 82 82 82 82 
53 53 53 53 53 53 53 53 53 53 53 53 53 53 53 53 53 53 53 0 1 2 3 55 69 65 70 54 53 53 53 53 79 85 82 82 82 82 82 82 82 82 82 82 82 82 82 82 82 82 
53 53 53 53 53 53 53 53 53 53 53 53 53 53 53 53 53 53 53 0 1 2 3 53 69 65 70 53 53 53 53 79 79 85 82 82 82 82 82 82 82 82 82 82 82 82 82 82 82 82 
53 53 53 53 53 53 53 53 53 53 53 53 53 53 53 53 53 53 53 0 1 2 3 53 69 65 70 53 53 53 53 79 79 84 82 82 82 82 82 82 82 82 82 82 82 82 82 82 82 82 
53 53 53 53 53 53 53 53 53 53 53 53 53 53 53 53 53 53 53 0 1 2 3 53 69 65 70 53 54 53 53 53 79 85 82 82 82 82 82 82 82 82 82 82 82 82 82 82 82 82 
53 53 53 53 53 53 53 53 53 53 53 53 53 53 53 53 53 53 53 0 1 2 3 53 69 65 70 53 54 53 53 53 79 84 82 82 82 82 82 82 82 82 82 82 82 82 82 82 82 82 
53 53 53 53 53 53 53 53 53 53 53 53 53 53 53 53 53 53 53 0 1 2 3 53 69 65 70 53 53 53 53 79 79 85 82 82 82 82 82 82 82 82 82 82 82 82 82 82 82 82 
53 53 53 53 53 53 53 53 53 53 53 53 53 53 53 53 53 53 53 0 1 2 3 55 69 65 70 53 53 53 53 79 79 84 82 82 82 82 82 82 82 82 82 82 82 82 82 82 82 82 
53 53 53 53 53 53 53 53 53 53 53 53 53 53 53 53 53 53 53 0 1 2 3 55 69 65 70 53 53 53 53 79 79 85 82 82 82 82 82 82 82 82 82 82 82 82 82 82 82 82 
53 53 53 53 53 53 53 53 53 53 53 53 53 53 53 53 53 53 53 0 1 2 3 53 69 65 70 53 53 53 53 79 79 84 82 82 82 82 82 82 82 82 82 82 82 82 82 82 82 82 
53 53 53 53 53 53 53 53 53 53 53 53 53 53 53 53 53 53 53 0 1 2 3 53 69 65 70 115 116 117 53 79 79 85 82 82 82 82 82 82 82 82 82 82 82 82 82 82 82 82 
53 53 53 53 53 53 53 53 53 53 53 53 53 53 53 53 53 53 53 0 1 2 3 53 69 65 70 5 6 7 53 79 79 84 82 82 82 82 82 82 82 82 82 82 82 82 82 82 82 82 
53 53 53 53 53 53 53 53 53 53 53 53 53 53 53 53 53 53 53 0 1 2 3 53 69 65 70 53 53 53 53 79 79 85 82 82 82 82 82 82 82 82 82 82 82 82 82 82 82 82 
53 53 53 53 53 53 53 53 53 53 53 53 53 53 53 53 53 53 53 0 1 2 3 53 69 65 70 53 53 53 53 53 79 84 82 82 82 82 82 82 82 82 82 82 82 82 82 82 82 82 
53 53 53 53 53 53 53 53 53 53 53 53 53 53 53 53 53 53 53 0 1 2 3 55 69 65 70 53 53 53 53 53 79 85 82 82 82 82 82 82 82 82 82 82 82 82 82 82 82 82 
53 53 53 53 53 53 53 53 53 53 53 53 53 53 53 53 53 53 53 0 1 2 3 53 69 65 70 54 53 53 53 53 79 84 82 82 82 82 82 82 82 82 82 82 82 82 82 82 82 82 
53 53 53 53 53 53 53 53 53 53 53 53 53 53 53 53 53 53 53 0 1 2 3 53 69 65 70 54 53 53 53 53 79 85 82 82 82 82 82 82 82 82 82 82 82 82 82 82 82 82 
53 53 53 53 53 53 53 53 53 53 53 53 53 53 53 53 53 53 53 0 1 2 3 53 69 65 70 53 53 53 53 53 79 84 82 82 82 82 82 82 82 82 82 82 82 82 82 82 82 82 
53 53 53 53 53 53 53 53 53 53 53 53 53 53 53 53 53 53 53 0 1 2 3 53 69 65 70 53 115 116 117 53 79 85 82 82 82 82 82 82 82 82 82 82 82 82 82 82 82 82 
53 53 53 53 53 53 53 53 53 53 53 53 53 53 53 53 53 53 53 0 1 2 3 55 69 65 70 53 5 6 7 53 79 84 82 82 82 82 82 82 82 82 82 82 82 82 82 82 82 82 
53 53 53 53 53 53 53 53 53 53 53 53 53 53 53 53 53 53 53 0 1 2 3 53 69 65 65 71 71 71 53 53 79 85 82 82 82 82 82 82 82 82 82 82 82 82 82 82 82 82 
53 53 53 53 53 53 53 53 53 53 53 53 53 53 53 53 53 53 53 0 1 2 3 53 67 66 66 66 66 66 53 53 79 84 82 82 82 82 82 82 82 82 82 82 82 82 82 82 82 82 
53 53 53 53 53 53 53 53 53 53 53 53 53 53 53 53 53 53 53 53 0 1 2 3 53 53 53 53 53 53 53 53 79 79 84 82 82 82 82 82 82 82 82 82 82 82 82 82 82 82 
53 53 53 53 53 53 53 53 53 53 53 53 53 53 53 53 53 53 53 53 53 0 1 2 3 53 115 116 117 0 1 2 3 79 85 82 82 82 82 82 82 82 82 82 82 82 82 82 82 82 
53 53 53 53 53 53 53 53 53 53 53 53 53 53 53 53 53 53 53 53 53 53 0 1 2 3 5 6 7 0 1 2 3 79 79 79 79 82 82 82 82 82 82 82 82 82 82 82 82 82 
53 53 53 53 53 53 53 53 53 53 53 53 53 53 53 53 53 53 53 53 53 53 53 53 53 53 53 53 53 53 53 0 1 2 3 79 79 79 82 82 82 82 82 82 82 82 82 82 82 82 
53 53 53 53 53 53 53 53 53 53 53 53 53 53 53 53 53 53 53 53 53 53 53 53 53 53 53 53 53 53 53 53 0 1 2 3 79 79 82 82 82 82 82 82 82 82 82 82 82 82 
53 53 53 53 53 53 53 53 53 53 53 53 53 53 53 53 53 53 53 53 53 53 53 53 53 53 53 53 53 53 53 53 0 1 2 3 79 79 82 82 82 82 82 82 82 82 82 82 82 82 
53 53 53 53 53 53 53 53 53 53 53 53 53 53 53 53 53 53 53 53 53 53 53 53 53 53 53 53 53 53 53 0 1 2 3 79 79 79 82 82 82 82 82 82 82 82 82 82 82 82 
