139 131 131 131 131 131 131 131 131 138 131 131 131 131 131 131 131 131 131 131 131 131 131 131 131 131 131 131 131 131 131 140 53 53 53 53 53 53 53 79 79 84 82 82 82 82 82 82 82 82 
132 51 127 50 50 127 50 50 127 132 50 127 50 50 127 50 50 127 50 50 127 50 50 127 50 50 127 50 50 127 52 132 53 53 53 53 53 53 53 79 79 85 82 82 82 82 82 82 82 82 
132 51 58 50 50 58 50 50 58 132 50 58 50 50 58 50 50 58 50 50 58 50 50 58 50 50 58 50 50 58 52 132 53 53 53 53 53 53 53 79 79 84 82 82 82 82 82 82 82 82 
132 316 316 316 307 308 316 316 316 132 53 53 380 381 53 380 381 53 380 381 53 380 381 53 380 381 53 53 53 53 53 132 53 53 53 115 116 117 53 79 79 85 82 82 82 82 82 82 82 82 
132 316 316 316 313 314 316 316 316 132 53 53 378 379 53 378 379 53 378 379 53 378 379 53 378 379 53 53 380 381 53 132 53 53 53 5 6 7 53 79 79 84 82 82 82 82 82 82 82 82 
132 316 317 318 319 320 321 322 316 132 53 255 114 114 114 114 114 114 114 114 114 114 114 114 114 114 114 252 378 379 53 132 53 53 53 53 53 53 53 79 79 85 82 82 82 82 82 82 82 82 
132 316 323 324 325 326 327 328 316 132 53 56 60 4 4 4 4 4 4 4 4 4 4 4 59 74 74 78 53 53 53 132 53 53 120 121 53 53 53 79 79 84 82 82 82 82 82 82 82 82 
132 316 329 330 331 332 333 334 316 132 53 56 78 380 381 53 380 381 53 380 381 53 380 381 56 74 74 78 380 381 53 132 53 53 118 119 53 53 53 79 79 85 82 82 82 82 82 82 82 82 
132 316 335 336 337 338 339 340 316 132 53 56 78 378 379 53 378 379 53 378 379 53 378 379 56 74 74 78 378 379 53 132 53 53 53 53 53 53 53 79 79 84 82 82 82 82 82 82 82 82 
132 316 341 342 343 344 345 346 316 132 53 56 129 114 114 114 114 114 114 114 114 114 114 114 128 74 74 78 53 53 53 132 53 53 53 53 115 116 117 79 79 85 82 82 82 82 82 82 82 82 
132 316 347 348 349 350 351 352 316 132 53 253 4 4 4 4 4 4 4 4 4 4 4 4 59 74 74 78 380 381 53 132 53 53 53 53 5 6 7 79 79 84 82 82 82 82 82 82 82 82 
132 316 316 354 355 356 357 316 316 132 53 53 53 53 53 53 53 53 53 53 53 53 53 53 56 74 74 78 378 379 53 132 53 53 53 53 53 53 53 79 79 85 82 82 82 82 82 82 82 82 
132 53 53 53 53 53 53 53 53 132 53 53 53 53 53 53 53 53 53 53 53 53 53 53 56 74 74 78 53 53 53 132 53 53 53 53 53 53 53 79 79 84 82 82 82 82 82 82 82 82 
136 131 131 489 490 493 494 131 131 135 53 53 53 380 381 53 380 381 53 380 381 53 380 381 56 74 74 78 380 381 53 132 53 53 53 53 53 53 53 79 79 85 82 82 82 82 82 82 82 82 
132 51 52 487 488 491 492 50 50 52 53 53 53 378 379 53 378 379 53 378 379 53 378 379 56 74 74 78 378 379 53 132 53 53 53 53 53 53 53 79 79 84 82 82 82 82 82 82 82 82 
132 255 114 114 114 114 114 114 114 114 114 114 114 114 114 114 114 114 114 114 114 114 114 114 128 74 74 78 53 53 53 132 53 53 53 53 53 53 53 79 79 85 82 82 82 82 82 82 82 82 
132 56 74 74 74 74 74 74 74 74 74 74 74 74 74 74 74 74 74 74 74 74 74 74 74 74 74 78 53 53 53 132 53 53 53 53 53 53 53 79 79 84 82 82 82 82 82 82 82 82 
134 131 131 131 131 131 131 131 131 131 131 131 131 131 131 131 131 131 131 131 131 131 131 141 59 74 74 78 142 131 131 135 53 53 53 53 53 53 53 79 79 85 82 82 82 82 82 82 82 82 
51 50 127 50 50 127 50 50 127 50 50 127 50 50 127 50 50 127 50 50 127 50 50 52 489 490 493 494 50 50 127 52 53 53 53 53 53 53 53 79 79 84 82 82 82 82 82 82 82 82 
51 50 58 50 50 58 50 50 58 50 50 58 50 50 58 50 50 58 50 50 58 50 50 52 487 488 491 492 50 50 58 52 53 53 53 53 53 53 53 79 79 85 82 82 82 82 82 82 82 82 
53 53 53 53 53 53 53 53 53 53 53 53 53 53 53 53 53 53 53 53 53 53 53 53 56 74 74 78 53 53 53 53 53 53 53 53 53 53 53 79 79 84 82 82 82 82 82 82 82 82 
53 53 53 53 53 53 53 53 53 53 53 53 53 53 53 53 53 53 53 53 53 53 53 53 56 77 74 78 53 53 53 53 53 53 53 53 53 53 53 79 79 85 82 82 82 82 82 82 82 82 
53 53 53 53 53 53 53 53 53 53 53 53 53 53 53 53 53 53 53 53 53 53 53 53 56 74 74 78 53 53 53 53 53 53 53 53 53 53 53 79 79 84 82 82 82 82 82 82 82 82 
53 53 53 53 53 53 53 53 53 53 53 53 53 53 53 53 53 53 53 53 53 53 53 53 56 74 74 78 53 53 53 53 53 53 53 53 53 53 53 79 79 85 82 82 82 82 82 82 82 82 
53 53 53 53 53 53 53 53 53 53 53 53 53 53 53 53 53 53 53 53 53 53 53 53 56 74 74 78 53 53 53 53 53 53 53 53 53 53 53 79 79 84 82 82 82 82 82 82 82 82 
53 53 53 53 53 53 53 53 53 53 53 53 53 53 53 53 53 53 53 53 53 53 53 53 56 74 74 78 53 53 53 53 53 53 53 53 53 120 121 79 79 85 82 82 82 82 82 82 82 82 
53 53 53 53 53 53 53 53 53 53 53 53 53 53 53 53 53 53 53 53 53 53 53 53 56 74 74 78 53 53 53 53 53 53 53 53 53 118 119 79 79 84 82 82 82 82 82 82 82 82 
53 53 53 53 53 53 53 53 53 53 53 53 53 53 53 53 53 53 53 53 53 53 53 53 56 76 74 78 53 53 53 53 53 53 53 53 53 120 121 79 79 85 82 82 82 82 82 82 82 82 
53 53 53 53 53 53 53 53 53 53 53 53 53 53 53 53 53 53 53 53 53 53 53 53 56 74 74 78 53 53 53 53 53 53 53 53 53 118 119 79 79 84 82 82 82 82 82 82 82 82 
53 53 53 53 53 53 53 53 53 53 53 53 53 53 53 53 53 53 53 53 53 53 53 53 56 74 74 78 53 53 53 53 53 53 53 53 53 53 53 79 79 85 82 82 82 82 82 82 82 82 
53 53 53 53 53 53 53 53 53 53 53 53 53 53 53 53 53 53 53 53 53 53 53 53 56 74 74 78 53 53 53 53 53 53 53 53 53 53 53 79 79 84 82 82 82 82 82 82 82 82 
53 53 53 53 53 53 53 53 53 53 53 53 53 53 53 53 53 53 53 53 53 53 53 53 56 75 74 78 53 53 53 53 53 53 53 53 53 53 53 79 79 85 82 82 82 82 82 82 82 82 
53 53 53 53 53 53 53 53 53 53 53 53 53 53 53 53 53 53 53 53 53 53 53 53 56 77 74 78 53 53 53 53 53 53 53 53 53 53 53 79 79 84 82 82 82 82 82 82 82 82 
53 53 53 53 53 53 53 53 53 53 53 53 53 53 53 53 53 53 53 53 53 53 146 147 56 74 74 78 53 53 53 53 53 53 53 53 53 120 121 79 79 85 82 82 82 82 82 82 82 82 
53 53 53 53 53 53 53 53 53 53 53 53 53 53 53 53 53 53 53 53 53 53 144 145 56 74 74 78 53 53 53 53 53 53 53 53 53 118 119 79 79 84 82 82 82 82 82 82 82 82 
53 53 53 53 53 53 53 53 53 53 53 53 53 53 53 53 53 53 53 53 53 53 146 147 56 74 74 78 53 53 53 53 53 53 53 53 53 53 53 79 79 85 82 82 82 82 82 82 82 82 
53 53 53 53 53 53 53 53 53 53 53 53 53 53 53 53 53 53 53 53 53 53 144 145 56 74 74 78 53 53 53 53 53 53 53 53 53 53 53 79 79 84 82 82 82 82 82 82 82 82 
53 53 53 53 53 53 53 53 53 53 53 53 53 53 53 53 53 53 53 53 53 53 53 53 56 74 74 78 53 53 53 53 53 53 53 53 53 53 53 79 79 85 82 82 82 82 82 82 82 82 
53 53 53 53 53 53 53 53 53 53 53 53 53 53 53 53 53 53 53 53 53 53 53 53 56 74 74 78 53 53 53 53 53 53 53 53 53 53 53 79 79 84 82 82 82 82 82 82 82 82 
53 53 53 53 53 53 53 53 53 53 53 53 53 53 53 53 53 53 53 53 53 53 146 147 56 74 74 78 53 53 53 53 53 53 53 115 116 117 53 79 79 85 82 82 82 82 82 82 82 82 
53 53 53 53 53 53 53 53 53 53 53 53 53 53 53 53 53 53 53 53 53 53 144 145 56 76 74 78 53 53 53 53 53 53 53 5 6 7 53 79 79 84 82 82 82 82 82 82 82 82 
53 53 53 53 53 53 53 53 53 53 53 53 53 53 53 53 53 53 53 53 53 53 53 53 56 75 74 129 114 114 114 114 114 114 114 114 114 252 53 79 79 85 82 82 82 82 82 82 82 82 
53 53 53 53 53 53 53 53 53 53 53 53 53 53 53 53 53 53 53 53 53 53 53 53 253 4 4 4 4 4 4 4 4 4 4 4 4 254 53 79 79 84 82 82 82 82 82 82 82 82 
53 53 53 53 53 53 53 53 53 53 53 53 53 53 53 53 53 53 53 53 53 53 53 53 53 53 53 53 53 53 53 53 53 53 53 53 53 53 53 79 79 85 82 82 82 82 82 82 82 82 
53 53 53 53 53 53 53 53 53 53 53 53 53 53 53 53 53 53 53 53 53 53 53 53 53 53 53 53 53 53 53 53 53 53 53 53 53 53 53 79 79 84 82 82 82 82 82 82 82 82 
53 53 53 53 53 53 53 53 53 53 53 53 53 53 53 53 53 53 53 53 53 53 53 53 53 53 53 53 53 53 53 53 53 53 53 53 53 53 53 79 79 85 82 82 82 82 82 82 82 82 
53 53 53 53 53 53 53 53 53 53 53 53 53 53 53 53 53 53 53 53 53 53 53 53 53 53 53 53 53 53 53 53 53 53 53 53 53 53 53 79 79 84 82 82 82 82 82 82 82 82 
53 53 53 53 53 53 53 53 53 53 53 53 53 53 53 53 53 53 53 53 53 53 53 53 53 53 53 53 53 53 53 53 53 53 53 53 53 53 53 79 79 85 82 82 82 82 82 82 82 82 
53 53 53 53 53 53 53 53 53 53 53 53 53 53 53 53 53 53 53 53 53 53 53 53 53 53 53 53 53 53 53 53 53 53 53 53 53 53 53 79 79 84 82 82 82 82 82 82 82 82 
53 53 53 53 53 53 53 53 53 53 53 53 53 53 53 53 53 53 53 53 53 53 53 53 53 53 53 53 53 53 53 53 53 53 53 53 53 53 53 79 79 85 82 82 82 82 82 82 82 82 
