139 131 131 131 131 131 131 131 131 131 131 131 131 131 131 131 131 131 131 131 131 131 131 131 131 131 131 131 131 131 131 140 53 53 53 53 53 53 53 79 79 84 82 82 82 82 82 82 82 82 
132 51 127 50 50 127 50 50 127 50 50 127 50 50 127 50 50 127 50 50 127 50 50 127 50 50 127 50 50 127 52 132 53 53 53 53 53 53 53 79 79 85 82 82 82 82 82 82 82 82 
132 51 58 50 50 58 50 50 58 50 50 58 50 50 58 50 50 58 50 50 58 50 50 58 50 50 58 50 50 58 52 132 53 53 53 53 53 53 53 79 79 84 82 82 82 82 82 82 82 82 
132 316 316 316 307 308 316 316 316 53 53 53 120 121 53 120 121 53 120 121 53 120 121 53 120 121 53 53 53 53 53 132 53 53 53 53 53 53 53 79 79 85 82 82 82 82 82 82 82 82 
132 316 316 316 313 314 316 316 316 53 53 53 118 119 53 118 119 53 118 119 53 118 119 53 118 119 53 53 53 53 53 132 53 53 53 53 53 53 53 79 79 84 82 82 82 82 82 82 82 82 
132 316 317 318 319 320 321 322 316 120 121 255 114 114 114 114 114 114 114 114 114 114 114 114 114 114 252 120 121 53 53 132 53 53 53 53 53 53 53 79 79 85 82 82 82 82 82 82 82 82 
132 316 323 324 325 326 327 328 316 118 119 56 60 4 4 4 4 4 4 4 4 4 4 4 59 74 78 118 119 53 53 132 53 53 53 53 53 53 53 79 79 84 82 82 82 82 82 82 82 82 
132 316 329 330 331 332 333 334 316 53 53 56 78 120 121 53 120 121 53 120 121 53 120 121 56 74 78 53 53 53 53 132 53 53 53 53 53 53 53 79 79 85 82 82 82 82 82 82 82 82 
132 316 335 336 337 338 339 340 316 120 121 56 78 118 119 53 118 119 53 118 119 53 118 119 56 74 78 120 121 53 53 132 53 53 53 53 53 53 53 79 79 84 82 82 82 82 82 82 82 82 
132 316 341 342 343 344 345 346 316 118 119 56 129 114 114 114 114 114 114 114 114 114 114 114 128 74 78 118 119 53 53 132 53 53 53 53 53 53 53 79 79 85 82 82 82 82 82 82 82 82 
132 316 347 348 349 350 351 352 316 53 53 253 4 4 4 4 4 4 4 4 4 4 4 4 59 74 78 53 53 53 53 132 53 53 53 53 53 53 53 79 79 84 82 82 82 82 82 82 82 82 
132 316 316 354 355 356 357 316 316 53 53 53 53 53 53 53 53 53 53 53 53 53 53 53 56 74 78 120 121 53 53 132 53 53 53 53 53 53 53 79 79 85 82 82 82 82 82 82 82 82 
132 53 53 255 114 114 114 114 114 114 114 114 114 114 114 114 114 114 114 114 114 114 114 114 128 74 78 118 119 53 53 132 53 53 53 53 53 53 53 79 79 84 82 82 82 82 82 82 82 82 
132 53 53 56 74 74 74 74 74 74 74 74 74 74 74 74 74 74 74 74 74 74 74 74 74 74 78 53 53 53 53 132 53 53 53 53 53 53 53 79 79 85 82 82 82 82 82 82 82 82 
132 53 53 253 4 4 4 4 4 4 4 4 4 4 4 4 4 4 4 4 4 4 4 4 59 74 78 53 53 53 53 132 53 53 53 53 53 53 53 79 79 84 82 82 82 82 82 82 82 82 
132 53 53 53 53 53 53 53 53 120 121 53 53 120 121 53 120 121 53 120 121 53 120 121 56 74 78 53 53 53 53 132 53 53 53 53 53 53 53 79 79 85 82 82 82 82 82 82 82 82 
132 53 53 53 53 53 53 53 53 118 119 53 53 118 119 53 118 119 53 118 119 53 118 119 56 74 78 53 53 53 53 132 53 53 53 53 53 53 53 79 79 84 82 82 82 82 82 82 82 82 
134 131 131 131 131 131 131 131 131 131 131 131 131 131 131 131 131 131 131 131 131 131 131 135 56 74 78 134 131 131 131 135 53 53 53 53 53 53 53 79 79 85 82 82 82 82 82 82 82 82 
51 50 127 50 50 127 50 50 127 50 50 127 50 50 127 50 50 127 50 50 127 50 50 52 56 74 78 51 50 50 127 52 53 53 53 53 53 53 53 79 79 84 82 82 82 82 82 82 82 82 
51 50 58 50 50 58 50 50 58 50 50 58 50 50 58 50 50 58 50 50 58 50 50 52 56 74 78 51 50 50 58 52 53 53 53 53 53 53 53 79 79 85 82 82 82 82 82 82 82 82 
53 53 53 53 53 53 53 53 53 53 53 53 53 53 53 53 53 53 53 53 53 53 53 53 56 74 78 53 53 53 53 53 53 53 53 53 53 53 53 79 79 84 82 82 82 82 82 82 82 82 
53 53 53 53 53 53 53 53 53 53 53 53 53 53 53 53 53 53 53 53 53 53 53 53 56 77 78 53 53 53 53 53 53 53 53 53 53 53 53 79 79 85 82 82 82 82 82 82 82 82 
53 53 53 53 53 53 53 53 53 53 53 53 53 53 53 53 53 53 53 53 53 53 53 53 56 74 78 53 53 53 53 53 53 53 53 53 53 53 53 79 79 84 82 82 82 82 82 82 82 82 
53 53 53 53 53 53 53 53 53 53 53 53 53 53 53 53 53 53 53 53 53 53 53 53 56 74 78 53 53 53 53 53 53 53 53 53 53 53 53 79 79 85 82 82 82 82 82 82 82 82 
53 53 53 53 53 53 53 53 53 53 53 53 53 53 53 53 53 53 53 53 53 53 53 53 56 74 78 53 53 53 53 53 53 53 53 53 53 53 53 79 79 84 82 82 82 82 82 82 82 82 
53 53 53 53 53 53 53 53 53 53 53 53 53 53 53 53 53 53 53 53 53 53 53 53 56 74 78 146 147 53 53 53 53 53 53 53 53 53 53 79 79 85 82 82 82 82 82 82 82 82 
53 53 53 53 53 53 53 53 53 53 53 53 53 53 53 53 53 53 53 53 53 53 53 53 56 74 78 144 145 53 53 53 53 53 53 53 53 53 53 79 79 84 82 82 82 82 82 82 82 82 
53 53 53 53 53 53 53 53 53 53 53 53 53 53 53 53 53 53 53 53 53 53 53 53 56 76 78 146 147 53 53 53 53 53 53 53 53 53 53 79 79 85 82 82 82 82 82 82 82 82 
53 53 53 53 53 53 53 53 53 53 53 53 53 53 53 53 53 53 53 53 53 53 53 53 56 74 78 144 145 53 53 53 53 53 53 53 53 53 53 79 79 84 82 82 82 82 82 82 82 82 
53 53 53 53 53 53 53 53 53 53 53 53 53 53 53 53 53 53 53 53 53 53 53 53 56 74 78 53 53 53 53 53 53 53 53 53 53 53 53 79 79 85 82 82 82 82 82 82 82 82 
53 53 53 53 53 53 53 53 53 53 53 53 53 53 53 53 53 53 53 53 53 53 53 53 56 74 78 53 53 53 53 53 53 53 53 53 53 53 53 79 79 84 82 82 82 82 82 82 82 82 
53 53 53 53 53 53 53 53 53 53 53 53 53 53 53 53 53 53 53 53 53 53 53 53 56 75 78 53 53 53 53 53 53 53 53 53 53 53 53 79 79 85 82 82 82 82 82 82 82 82 
53 53 53 53 53 53 53 53 53 53 53 53 53 53 53 53 53 53 53 53 53 53 53 53 56 77 78 53 53 53 53 53 53 53 53 53 53 53 53 79 79 84 82 82 82 82 82 82 82 82 
53 53 53 53 53 53 53 53 53 53 53 53 53 53 53 53 53 53 53 53 53 53 146 147 56 74 78 53 53 53 53 53 53 53 53 53 53 53 53 79 79 85 82 82 82 82 82 82 82 82 
53 53 53 53 53 53 53 53 53 53 53 53 53 53 53 53 53 53 53 53 53 53 144 145 56 74 78 146 147 53 53 53 53 53 53 53 53 53 53 79 79 84 82 82 82 82 82 82 82 82 
53 53 53 53 53 53 53 53 53 53 53 53 53 53 53 53 53 53 53 53 53 53 146 147 56 74 78 144 145 53 53 53 53 53 53 53 53 53 53 79 79 85 82 82 82 82 82 82 82 82 
53 53 53 53 53 53 53 53 53 53 53 53 53 53 53 53 53 53 53 53 53 53 144 145 56 74 78 53 53 53 53 53 53 53 53 53 53 53 53 79 79 84 82 82 82 82 82 82 82 82 
53 53 53 53 53 53 53 53 53 53 53 53 53 53 53 53 53 53 53 53 53 53 53 53 56 74 78 53 53 53 53 53 53 53 53 53 53 53 53 79 79 85 82 82 82 82 82 82 82 82 
53 53 53 53 53 53 53 53 53 53 53 53 53 53 53 53 53 53 53 53 53 53 53 53 56 74 78 53 53 53 53 53 53 53 53 53 53 53 53 79 79 84 82 82 82 82 82 82 82 82 
53 53 53 53 53 53 53 53 53 53 53 53 53 53 53 53 53 53 53 53 53 53 146 147 56 74 78 53 53 53 53 53 53 53 53 115 116 117 53 79 79 85 82 82 82 82 82 82 82 82 
53 53 53 53 53 53 53 53 53 53 53 53 53 53 53 53 53 53 53 53 53 53 144 145 56 76 78 53 53 53 53 53 53 53 53 5 6 7 53 79 79 84 82 82 82 82 82 82 82 82 
53 53 53 53 53 53 53 53 53 53 53 53 53 53 53 53 53 53 53 53 53 53 53 53 56 75 129 114 114 114 114 114 114 114 114 114 114 252 53 79 79 85 82 82 82 82 82 82 82 82 
53 53 53 53 53 53 53 53 53 53 53 53 53 53 53 53 53 53 53 53 53 53 53 53 253 4 4 4 4 4 4 4 4 4 4 4 4 254 53 79 79 84 82 82 82 82 82 82 82 82 
53 53 53 53 53 53 53 53 53 53 53 53 53 53 53 53 53 53 53 53 53 53 53 53 53 53 53 53 53 53 53 53 53 53 53 53 53 53 53 79 79 85 82 82 82 82 82 82 82 82 
53 53 53 53 53 53 53 53 53 53 53 53 53 53 53 53 53 53 53 53 53 53 53 53 53 53 53 53 53 53 53 53 53 53 53 53 53 53 53 79 79 84 82 82 82 82 82 82 82 82 
53 53 53 53 53 53 53 53 53 53 53 53 53 53 53 53 53 53 53 53 53 53 53 53 53 53 53 53 53 53 53 53 53 53 53 53 53 53 53 79 79 85 82 82 82 82 82 82 82 82 
53 53 53 53 53 53 53 53 53 53 53 53 53 53 53 53 53 53 53 53 53 53 53 53 53 53 53 53 53 53 53 53 53 53 53 53 53 53 53 79 79 84 82 82 82 82 82 82 82 82 
53 53 53 53 53 53 53 53 53 53 53 53 53 53 53 53 53 53 53 53 53 53 53 53 53 53 53 53 53 53 53 53 53 53 53 53 53 53 53 79 79 85 82 82 82 82 82 82 82 82 
53 53 53 53 53 53 53 53 53 53 53 53 53 53 53 53 53 53 53 53 53 53 53 53 53 53 53 53 53 53 53 53 53 53 53 53 53 53 53 79 79 84 82 82 82 82 82 82 82 82 
53 53 53 53 53 53 53 53 53 53 53 53 53 53 53 53 53 53 53 53 53 53 53 53 53 53 53 53 53 53 53 53 53 53 53 53 53 53 53 79 79 85 82 82 82 82 82 82 82 82 
