256 256 256 256 256 256 256 256 256 256 256 256 256 256 139 131 131 131 131 131 131 131 131 131 131 131 131 131 131 131 131 131 131 131 140 256 256 256 256 256 256 256 256 256 256 256 256 256 256 256 
256 256 256 256 256 256 256 256 256 256 256 256 256 256 132 127 50 50 127 50 50 127 50 50 127 50 50 127 50 50 127 50 50 127 132 256 256 256 256 256 256 256 256 256 256 256 256 256 256 256 
256 256 256 256 256 256 256 256 256 256 256 256 256 256 132 58 50 50 58 50 50 58 50 50 58 50 50 58 50 50 58 50 50 58 132 256 256 256 256 256 256 256 256 256 256 256 256 256 256 256 
256 256 256 256 256 256 256 256 256 256 256 256 256 256 132 51 50 50 50 50 50 50 50 50 50 50 50 50 50 50 50 50 50 52 132 256 256 256 256 256 256 256 256 256 256 256 256 256 256 256 
256 256 256 256 256 256 256 256 256 256 256 256 256 256 132 51 50 50 50 50 50 50 50 112 111 113 50 50 50 50 50 50 50 52 132 256 256 256 256 256 256 256 256 256 256 256 256 256 256 256 
256 256 256 256 256 256 256 256 256 256 256 256 256 256 132 8 8 8 8 8 8 8 8 109 108 110 8 8 8 8 8 8 8 8 132 256 256 256 256 256 256 256 256 256 256 256 256 256 256 256 
256 256 256 256 256 256 256 256 256 256 256 256 256 256 132 8 8 8 8 8 8 8 8 9 8 10 8 8 8 8 8 8 8 8 132 256 256 256 256 256 256 256 256 256 256 256 256 256 256 256 
256 256 256 256 256 256 256 256 256 256 256 256 256 256 132 8 8 8 8 8 8 8 8 9 8 10 8 8 8 8 8 8 8 8 132 256 256 256 256 256 256 256 256 256 256 256 256 256 256 256 
256 256 256 256 256 256 256 256 256 256 256 256 256 256 132 86 86 86 86 86 86 86 86 87 86 88 86 86 86 86 86 86 86 86 132 256 256 256 256 256 256 256 256 256 256 256 256 256 256 256 
256 256 256 256 256 256 256 256 256 256 256 256 256 256 132 86 86 86 86 86 86 86 86 87 86 88 86 86 86 86 86 86 86 86 132 256 256 256 256 256 256 256 256 256 256 256 256 256 256 256 
256 256 256 256 256 256 256 256 256 256 256 256 256 256 132 86 86 86 86 86 86 86 86 87 86 88 86 86 86 86 86 86 86 86 132 256 256 256 256 256 256 256 256 256 256 256 256 256 256 256 
256 256 256 256 256 256 256 256 256 256 256 256 256 256 132 11 11 11 11 11 11 11 11 9 8 10 11 11 11 11 11 11 11 11 132 256 256 256 256 256 256 256 256 256 256 256 256 256 256 256 
256 256 256 256 256 256 256 256 256 256 256 256 256 256 132 11 11 11 11 11 11 11 11 9 8 10 11 11 11 11 11 11 11 11 132 256 256 256 256 256 256 256 256 256 256 256 256 256 256 256 
256 256 256 256 256 256 256 256 256 256 256 256 256 256 132 11 106 105 105 105 107 11 11 9 8 10 11 11 11 11 11 11 11 11 132 256 256 256 256 256 256 256 256 256 256 256 256 256 256 256 
256 256 256 256 256 256 256 256 256 256 256 256 256 256 132 11 103 102 102 102 104 11 11 9 8 10 11 11 11 11 11 11 11 11 132 256 256 256 256 256 256 256 256 256 256 256 256 256 256 256 
256 256 256 256 256 256 256 256 256 256 256 256 256 256 132 11 100 99 99 99 101 11 11 9 8 10 11 11 11 11 11 11 11 11 132 256 256 256 256 256 256 256 256 256 256 256 256 256 256 256 
256 256 256 256 256 256 256 256 256 256 256 256 256 256 132 11 11 11 11 11 11 11 11 9 8 10 11 11 11 11 11 11 11 11 132 256 256 256 256 256 256 256 256 256 256 256 256 256 256 256 
256 256 256 256 256 256 256 256 256 256 256 256 256 256 132 11 11 11 11 11 11 11 11 9 8 10 11 11 106 105 105 105 107 11 132 256 256 256 256 256 256 256 256 256 256 256 256 256 256 256 
256 256 256 256 256 256 256 256 256 256 256 256 256 256 136 11 11 11 11 11 11 11 11 9 8 10 11 11 103 102 102 102 104 11 137 256 256 256 256 256 256 256 256 256 256 256 256 256 256 256 
256 256 256 256 256 256 256 256 256 256 256 256 256 256 132 11 11 11 11 11 11 11 11 9 8 10 11 11 100 99 99 99 101 11 132 256 256 256 256 256 256 256 256 256 256 256 256 256 256 256 
256 256 256 256 256 256 256 256 256 256 256 256 256 256 132 11 11 11 11 11 11 11 11 9 8 10 11 11 11 11 11 11 11 11 132 256 256 256 256 256 256 256 256 256 256 256 256 256 256 256 
256 256 256 256 256 256 256 256 256 256 256 256 256 256 132 131 131 131 131 131 131 131 11 9 8 10 11 131 131 131 131 131 131 131 137 256 256 256 256 256 256 256 256 256 256 256 256 256 256 256 
256 256 256 256 256 256 256 256 256 256 256 256 256 256 132 51 127 50 50 50 127 52 11 9 8 10 11 51 127 50 50 50 127 52 132 256 256 256 256 256 256 256 256 256 256 256 256 256 256 256 
256 256 256 256 256 256 256 256 256 256 256 256 256 256 132 51 58 50 50 50 58 52 11 9 8 10 11 51 58 50 50 50 58 52 132 256 256 256 256 256 256 256 256 256 256 256 256 256 256 256 
256 256 256 256 256 256 256 256 256 256 256 256 256 256 132 11 11 11 11 11 11 11 11 9 8 10 11 11 11 11 11 11 11 11 132 256 256 256 256 256 256 256 256 256 256 256 256 256 256 256 
256 256 256 256 256 256 256 256 256 256 256 256 256 256 132 11 11 106 105 107 11 11 11 9 8 10 11 11 11 106 105 107 11 11 132 256 256 256 256 256 256 256 256 256 256 256 256 256 256 256 
256 256 256 256 256 256 256 256 256 256 256 256 256 256 132 11 11 103 102 104 11 11 11 9 8 10 11 11 11 103 102 104 11 11 132 256 256 256 256 256 256 256 256 256 256 256 256 256 256 256 
256 256 256 256 256 256 256 256 256 256 256 256 256 256 132 11 11 100 99 101 11 11 11 9 8 10 11 11 11 100 99 101 11 11 132 256 256 256 256 256 256 256 256 256 256 256 256 256 256 256 
256 256 256 256 256 256 256 256 256 256 256 256 256 256 132 11 11 11 11 11 11 11 11 9 8 10 11 11 11 11 11 11 11 11 132 256 256 256 256 256 256 256 256 256 256 256 256 256 256 256 
256 256 256 256 256 256 256 256 256 256 256 256 256 256 136 131 131 131 131 131 131 141 11 9 8 10 11 142 131 131 131 131 131 131 137 256 256 256 256 256 256 256 256 256 256 256 256 256 256 256 
256 256 256 256 256 256 256 256 256 256 256 256 256 256 132 51 127 50 50 50 127 52 11 9 8 10 11 51 127 50 50 50 127 52 132 256 256 256 256 256 256 256 256 256 256 256 256 256 256 256 
256 256 256 256 256 256 256 256 256 256 256 256 256 256 132 51 58 50 50 50 58 52 11 9 8 10 11 51 58 50 50 50 58 52 132 256 256 256 256 256 256 256 256 256 256 256 256 256 256 256 
256 256 256 256 256 256 256 256 256 256 256 256 256 256 132 11 11 11 11 11 11 11 11 9 8 10 11 11 11 11 11 11 11 11 132 256 256 256 256 256 256 256 256 256 256 256 256 256 256 256 
256 256 256 256 256 256 256 256 256 256 256 256 256 256 132 11 11 11 11 11 11 11 11 9 8 10 11 11 11 11 11 11 11 11 132 256 256 256 256 256 256 256 256 256 256 256 256 256 256 256 
256 256 256 256 256 256 256 256 256 256 256 256 256 256 132 11 11 106 105 107 11 11 11 9 8 10 11 11 11 106 105 107 11 11 132 256 256 256 256 256 256 256 256 256 256 256 256 256 256 256 
256 256 256 256 256 256 256 256 256 256 256 256 256 256 132 11 11 103 102 104 11 11 11 9 8 10 11 11 11 103 102 104 11 11 132 256 256 256 256 256 256 256 256 256 256 256 256 256 256 256 
256 256 256 256 256 256 256 256 256 256 256 256 256 256 132 11 11 100 99 101 11 11 11 9 8 10 11 11 11 100 99 101 11 11 132 256 256 256 256 256 256 256 256 256 256 256 256 256 256 256 
256 256 256 256 256 256 256 256 256 256 256 256 256 256 132 11 11 11 11 11 11 11 11 9 8 10 11 11 11 11 11 11 11 11 132 256 256 256 256 256 256 256 256 256 256 256 256 256 256 256 
256 256 256 256 256 256 256 256 256 256 256 256 256 256 132 11 11 11 11 11 11 11 11 9 8 10 11 11 11 11 11 11 11 11 132 256 256 256 256 256 256 256 256 256 256 256 256 256 256 256 
256 256 256 256 256 256 256 256 256 256 256 256 256 256 132 11 11 11 11 11 11 11 11 9 8 10 11 11 11 11 11 11 11 11 132 256 256 256 256 256 256 256 256 256 256 256 256 256 256 256 
256 256 256 256 256 256 256 256 256 256 256 256 256 256 136 131 131 131 131 131 131 141 11 9 8 10 11 142 131 131 131 131 131 131 137 256 256 256 256 256 256 256 256 256 256 256 256 256 256 256 
256 256 256 256 256 256 256 256 256 256 256 256 256 256 132 51 127 50 50 50 127 52 11 9 8 10 11 51 127 50 50 50 127 52 132 256 256 256 256 256 256 256 256 256 256 256 256 256 256 256 
256 256 256 256 256 256 256 256 256 256 256 256 256 256 132 51 58 50 50 50 58 52 11 9 8 10 11 51 58 50 50 50 58 52 132 256 256 256 256 256 256 256 256 256 256 256 256 256 256 256 
256 256 256 256 256 256 256 256 256 256 256 256 256 256 132 11 11 11 11 11 11 11 11 9 8 10 11 11 11 11 11 11 11 11 132 256 256 256 256 256 256 256 256 256 256 256 256 256 256 256 
256 256 256 256 256 256 256 256 256 256 256 256 256 256 132 11 11 11 11 11 11 11 11 9 8 10 11 11 11 11 11 11 11 11 132 256 256 256 256 256 256 256 256 256 256 256 256 256 256 256 
256 256 256 256 256 256 256 256 256 256 256 256 256 256 132 11 11 11 11 11 11 11 11 9 8 10 11 11 11 11 11 11 11 11 132 256 256 256 256 256 256 256 256 256 256 256 256 256 256 256 
256 256 256 256 256 256 256 256 256 256 256 256 256 256 132 11 11 11 11 11 11 11 11 9 8 10 11 11 11 11 11 11 11 11 132 256 256 256 256 256 256 256 256 256 256 256 256 256 256 256 
256 256 256 256 256 256 256 256 256 256 256 256 256 256 132 11 11 11 11 11 11 11 11 9 8 10 11 11 11 11 11 11 11 11 132 256 256 256 256 256 256 256 256 256 256 256 256 256 256 256 
256 256 256 256 256 256 256 256 256 256 256 256 256 256 132 11 11 11 11 11 11 11 11 9 8 10 11 11 11 11 11 11 11 11 132 256 256 256 256 256 256 256 256 256 256 256 256 256 256 256 
256 256 256 256 256 256 256 256 256 256 256 256 256 256 134 131 131 131 131 131 131 131 131 131 131 131 131 131 131 131 131 131 131 131 135 256 256 256 256 256 256 256 256 256 256 256 256 256 256 256 
